████████████████
     █       ███
███  █  ███  ███
███     ███    █
██████  █████  █
██      █      █
█████████  █████